##########
#.......N#
#.####...#
#.#....E.#
#.#..#...#
###..#####
#........#
#.#..#..E#
######...#
######...#
######...#
######.###
#....N...#
#P.......#
##########
